########################################
#            #                         #
#            #                         #
#            #                         #
#            #                         #
#            #                         #
#            #                         #
#            #            #            #
#            #            #            #
#            #            #            #
#            #            #            #
#            #            #            #
#            #            #            #
#            #            #            #
#            #            #            #
#            #            #            #
#            #            #            #
#                         #            #
#                         #            #
#                         #            #
#                         #            #
#                         #            #
#                         #            #
#                         #            #
#                         #            #
#                         #            #
#                                      #
#                                      #
#                                      #
#                                      #
#           ############################
#                                      #
#                                      #
#                                      #
#                                      #
#                                      #
#                                      #
#                                      #
#                                      #
########################################