########################################
#                                      #
#                                      #
#                                      #
#                                      #
#                                      #
#                                      #
#                                      #
#                                      #
#               ########               #
#               #      #               #
#               #      #               #
#               #      #               #
#               #                      #
#               #                      #
#               #                      #
#               #                      #
#               #                      #
#               #      #               #
#               #      #               #
#               #      #               #
#                      #               #
#                      #               #
#                      #               #
#                      #               #
#                      #               #
#               #      #               #
#               #      #               #
#               #      #               #
#               ########               #
#                                      #
#                                      #
#                                      #
#                                      #
#                                      #
#                                      #
#                                      #
#                                      #
#                                      #
########################################
