########################################
#      *     #                     *   #
#            #                         #
#            #                         #
#            #          *              #
#            #                         #
#            #                         #
#            #            #            #
#            #            #            #
#            #            #            #
#            #            #            #
#            #            #            #
#            #            #            #
#            #            #            #
#            #            #   *        #
#            #            #            #
#            #            #            #
#                         #            #
#            *            #            #
#                         #            #
#     *                   #            #
#                         #            #
#                         #            #
#                                      #
#                                      #
#                                      #
#                                      #
#                                      #
#                                    * #
#                                      #
#        *  ############################
#                                      #
#                                  *   #
#                                      #
#                                      #
#                                      #
#                                      #
#    *                                 #
#                                      #
########################################