########################################
#            #            #            #
#      *     #      *     #            #
#            #            #      *     #
#            #            #            #
#                         #            #
#                         #            #
#                         #            #
#            *            #            #
#                         #            #
#                         #            #
#            #            #            #
#            #            #            #
#            #            #            #
#            #            #            #
#            #            #            #
#            #            #            #
#            #            #            #
#            #            #            #
#      *     #            #      *     #
#            #            #            #
#            #            #            #
#            #            #            #
#            #            #            #
#            #            #            #
#            #            #            #
#            #            #            #
#            #            #            #
#            #            #            #
#            #                         #
#            #                         #
#            #            *            #
#            #                         #
#            #                         #
#            #                         #
#     *      #            #            #
#            #            #            #
#            # *          #          * #
#            #            #            #
########################################