########################################
#            #                         #
#      *     #                    *    #
#            #                         #
#            #                         #
#                      #################
#                                      #
#                                      #
#       #                              #
#       #                              #
#       #                  #           #
#       #                  #           #
#       #         ##########           #
#       #                  #           #
#       #              *   #           #
#       #                  #     *     #
#       #                  #           #
#       #########          #############
#               #                      #
#               #                      #
#               #                      #
#               #                      #
#       #########                      #
#               #        #     *       #
#   *           #   *    #             #
#               #        #             #
#               #        ###############
#               #        #             #
#               #        #             #
#         #######        #             #
#         #                            #
#         #   *                        #
#         #                            #
#         #                            #
#         ##########                   #
#     *      #                         #
#            #             #           #
#            #  *          #    *      #
#            #             #           #
########################################