########################################
#            #                         #
#      *     #                    *    #
#            #                         #
#            #         #################
#                                      #
#                                      #
#                                      #
#       ##########         #           #
#       #                  #           #
#       #                  #           #
#       #                  #           #
#       #         ##########           #
#       #                  #           #
#       #              *   #           #
#       #                  #     *     #
#       #                  #           #
#       #########          #############
#               #                      #
#               #                      #
#               #                      #
#       ##################             #
#               #        #             #
#               #   *    #             #
#   *           #        #             #
#               #        #             #
######          #        #             #
#               #        #             #
#               #        #             #
#         #######        #             #
#         #                            #
#         #   *                        #
#         #                            #
#         ##########       #           #
#            #             #           #
#     *      #             #           #
#            #             #           #
#            #  *          #    *      #
#            #             #           #
########################################