########################################
#            #                         #
#      *     #                    *    #
#            #                         #
#            #                         #
#                      #################
#                                      #
#                                      #
#       #                              #
#       #                              #
#       #                              #
#       #        ###########           #
#       #                              #
#       #                              #
#       #              *               #
#       #                        *     #
#       #                              #
#       #########          #############
#               #                      #
#               #                      #
#               #                      #
#               #                      #
#               #                      #
#               #        #     *       #
#   *           #   *    #             #
#               #        #             #
#               #        ###############
#         #######        #             #
#                        #             #
#                        #             #
#             *                        #
#                                      #
#                                      #
#         ####                         #
#            #                         #
#     *      #                         #
#            #             #           #
#            #     *       #     *     #
#            #             #           #
########################################