########################################
#                                      #
#                              *       #
#      *                               #
#                                      #
#                                      #
#                                      #
#                                      #
#                                      #
#              *                       #
#                                      #
#                                      #
#                                      #
#                        *             #
#                                      #
#                                      #
#       *                              #
#                                      #
#                                      #
#                          *           #
#                                      #
#                                      #
#                                      #
#                                      #
#                                      #
#        *                             #
#                                      #
#                                      #
#                             *        #
#                                      #
#                                      #
#                                      #
#                                      #
#                                      #
#                                      #
#             *                *       #
#                                      #
#                                      #
#                                      #
########################################