########################################
#                                      #
# *                                  * #
#                                      #
#                                      #
#                                      #
#                                      #
#                                      #
#                                      #
#       *       ########               #
#               #      #               #
#               # *    #               #
#               #      #               #
#               #                      #
#               #                      #
#               #      *               #
#               #                      #
#               #                      #
#               #      #               #
#               #      #               #
#               #      #               #
#                      #               #
#                      #               #
#               *      #               #
#                      #               #
#                      #               #
#               #      #               #
#               #    * #               #
#               #      #               #
#               ########       *       #
#                                      #
#                                      #
#                                      #
#                                      #
#                                      #
#                                      #
#                                      #
# *                                  * #
#                                      #
########################################
